20
20
....................
....................
....................
....................
....................
....................
....................
....................
...XWWWWWWWWWU......
...VSTSSTTSSSQ......
...VSSSTTSSSSQ......
...VSSSTSTSSSQ......
...VSSSSTTSSSQ......
...2PPPPPPPPPY......
....................
....................
....................
....................
....................
....................
....................